good|adj. 好的
morning|n. 早晨；上午
good morning|早上好
hi|interj. （用于打招呼）嗨；喂
hello|interj. 你好；喂
afternoon|n. 下午
good afternoon|下午好
evening|n. 晚上；傍晚
good evening|晚上好
how|adv. 怎样；如何
are|v. 是
you|pron. 你；你们
how are you|你好吗
I|pron. 我
am|v. 是
fine|adj. 健康的；美好的
thanks|interj. & n. 感谢；谢谢
OK|interj. & adv. 好；可以
HB|（铅笔芯）硬黑
CD|光盘；激光唱片
BBC|英国广播公司
what|pron. & adj. 什么
is|v. 是
this|pron. 这；这个
in|prep. （表示使用语言、材料等）用；以
English|n. 英语 adj. 英格兰的； 英语的
in English|用英语
map|n. 地图
cup|n. 杯子
ruler|n. 尺子；直尺
pen|n. 笔；钢笔
orange|n. 橙子
jacket|n. 夹克衫；短上衣
key|n. 钥匙
quilt|n. 被子；床罩
a|art.一（人、事、物）
that|pron. 那；那个
spell|v. 用字母拼；拼写
please|interj. （用于客气地请求或吩咐）请
NBA|（美国）全国篮球协会
P|停车场；停车位
kg|千克；公斤
it|pron. 它
color|n. ( = colour) 颜色
red|adj. & n. 红色(的)
yellow|adj. & n. 黄色(的)
green|adj. & n. 绿色(的)
blue|adj.& n. 蓝色(的)
black|adj. & n. 黑色(的)
white|adj. & n. 白色(的)
purple|adj. & n. 紫色(的)
brown|adj. & n. 棕色(的)；褐色(的)
the|art. 指已提到或易领会到的人或事物
now|adv. 现在；目前
see|v. 理解；明白
can|modal v. 能；会
say|v. 说；讲
my|pron. 我的
UFO|不明飞行物
CCTV|中国中央电视台
name|n. 名字；名称
nice|adj. 令人愉快的；宜人的
to|常用于原形动词之前，表示该动词为不定式
meet|v. 遇见；相逢
too|adv. 也；又；太
your|pron. 你的；你们的
Ms.|女士
and|conj. 和；又；而
her|pron. 她的
yes|interj. 是的；可以
she|pron. 她
he|pron. 他
no|adv. & adj. 不；没有；不是
not|adv. 不；没有
zero|num. 零
one|num. 一
two|num. 二
three|num. 三
four|num. 四
five|num. 五
six|num. 六
seven|num. 七
eight|num. 八
nine|num. 九
telephone|n. 电话； 电话机
number|n. 号码；数字
phone|n. 电话；电话机
telephone number| 电话号码
first|adj. 第一
first name|名字
last|adj. 最后的；末尾的
last name|姓
friend|n. 朋友
china|中国
middle|adj. 中间的 n.中间
school|n. 学校
middle school|中学；初中
his|pron. 他的
sister|n. 姐；妹
mother|n. 母亲；妈妈
father|n. 父亲；爸爸
parent|n. 父（母）亲
brother|n. 兄；弟
grandmother|n. （外）祖母；奶奶；外婆；姥姥
grandfather|n. （外）祖父；爷爷；外公；姥爷
grandparent|n. 祖父(母)；外祖父（母）
family|n. 家；家庭
those|pron. 那些
who|pron. 谁；什么人
oh|interj. 哦；啊
these|pron. 这些
they|pron. 他（她、它）们
well|interj. 嗯；好吧
have|v. 经受；经历
day|n. 一天；一日；白天
bye|interj.  再见
son|n. 儿子
cousin|n. 堂兄（弟、姊、妹）；表兄（弟、姊、妹）
grandpa|n. （外）祖父；爷爷； 外公；姥爷
mom|n. （=mum）妈妈
aunt|n. 姑母；姨母；伯母；婶母；舅母
grandma|n. （外）祖母；奶奶；外婆；姥姥
dad|n. 爸爸
uncle|n. 舅父；叔父；伯父；姑父；姨父
daughter|n. 女儿
here|adv.（用以介绍某人或某物）这就是；在这里
photo|n. 照片
of|prep. 属于（某人或某物）；关于（某人或某物）
next|adj. & n. 下一个（的）；接下来（的）
picture|n. 照片；图画
girl|n. 女孩
dog|n. 狗
have a good day|(表示祝愿)过得愉快
pencil|n. 铅笔
book|n. 书
eraser|n. 橡皮
box|n. 箱；盒
pencil box|铅笔盒；文具盒
schoolbag|n. 书包
dictionary|n. 词典；字典
mine|pron. 我的
hers|pron. 她的
excuse|v. 原谅；宽恕
me|pron.（I的宾格） 我
excuse me|劳驾；请原谅
thank|v. 感谢；谢谢
teacher|n. 老师；教师
about|prep. 关于 adv. 大约
what about|（询问消息或提出建议） ... 怎么样？…好吗？
yours|pron. 你的；你们的
for|prep. 为了；给；对
Thank you for|为…而感谢你（们）
help|v. & n. 帮助；援助
welcome|adj. 受欢迎的
watch|n. 表；手表
computer|n. 计算机；电脑
game|n. 游戏；运动；比赛
card|n. 卡片
ID card|学生卡；身份证
notebook|n. 笔记本
ring|n. 戒指
bag|n. 袋；包
in|prep. 在...里
library|n. 图书馆
ask|v. 请求；要求；询问
ask for|… 请求；恳求（给予）
find|v.找到；发现
some|adj. 一些；某些 pron. 有些；有的
classroom|n. 教室
e-mail|v.给…发电子邮件；用电邮发送 n. 电子邮件
at|prep. 按照；根据；在（某处，某时间或时刻）
call|v.（给…） 打电话
lost|v.遗失；丢失
must|modal v. 必须
set|n. 一套；一副；一组
a set of|一套；一副；一组
you're welcome|别客气
his|pron. 他的
baseball|n. 棒球
where|adv. 在哪里； 到哪里
table|n. 桌子
bed|n. 床
bookcase|n. 书架； 书柜
chair|n. 椅子
on|prep. 在……上
under|prep. 在……下
come|v. 来；来到
come on|快点儿
think|v. 认为；想；思考
room|n. 房间
their|pron. 他（她、它）们的
hat|n. 帽子
head|n. 头
yeah|interj. 是的；对
know|v. 知道；了解
radio|n. 收音机；无线电广播
clock|n. 时钟
tape|n. 磁带；录音带；录像带
player|n. 播放机
tape player|磁带播放机
model|n. 模型
plane|n.飞机
model plane|飞机模型
tidy|adj. 整洁的；井井有条的
but|conj. 但是
everywhere|adv. 处处；到处；各个地方
sofa|n. 沙发
desk|n. 书桌
our|pron. 我们的
always|adv. 总是
do|aux v. & v. 用于构成否定句或疑问句；做；干
have|v. 有
tennis|n. 网球
ball|n. 球
ping-pong|n. 乒乓球
bat|n. 球棒；球拍
soccer|n. （英式）足球
soccer ball|英式足球
volleyball|n. 排球
basketball|n. 篮球
hey|interj. 嘿；喂
let|v. 允许；让
us|pron. （we的宾格）我们
go|v. 去；走
we|pron. 我们
late|adj. 迟到
get|v. 去取（或带来）；得到
great|adj. 美妙的； 伟大的
play|v. 参加（比赛或运动）；玩耍
sound|v. 听起来好像
interesting|adj. 有趣的
boring|adj. 没趣的； 令人厌倦的
fun|adj. 有趣的；使人快乐的 n. 乐趣；快乐
difficult|adj. 困难的
relaxing|adj. 轻松的；令人放松的
watch|v. 注视；观看
TV|n.  电视；电视机
watch TV|看电视
same|adj. 相同的
love|v. & n. 爱；喜爱
with|prep. 和……在一起；带有；使用
sport|n. 体育运动
them|pron. （they的宾格）他（她、它）们
only|adv. 只；仅
like|v. 喜欢；喜爱
easy|adj. 容易的；不费力的
after|prep. & conj. 在……以后
class|n. 班级；课
classmate|n. 同班同学
let's|(=let us)让我们（一起）
banana|n. 香蕉
hamburger|n. 汉堡包
ice-cream|n. 冰淇淋
salad|n. 沙拉
strawberry|n. 草莓
pear|n. 梨
milk|n. 牛奶
bread|n. 面包
birthday|n. 生日
dinner|n. （中午或晚上吃的）正餐
week|n. 周；星期
think about|思考；思索
food|n. 食物
sure|adv. 当然；肯定；一定
how about|（提出建议）……怎么样？
burger|n. （= hamburger）汉堡包
vegetable|n. 蔬菜
fruit|n. 水果
right|adj. 正确的；适当的
apple|n. 苹果
then|adv. 那么
egg|n. 蛋；鸡蛋
carrot|n. 胡萝卜
rice|n. 大米；米饭
chicken|n. 鸡肉
so|conj. （引出评论或问题）那么
breakfast|n. 早餐；早饭
lunch|n. 午餐
star|n. 明星；星星
eat|v. 吃
well|adv. 好；令人满意地
habit|n. 习惯
healthy|adj. 健康的
really|adv. 真正地
question|n. 问题
want|v. 需要；想要
be|v. 变成
fat|adj. 肥的；肥胖的
tomato|n. 西红柿
much|pron. & adj. 许多；大量；多少
how much|（购物时）……多少钱？
sock|n. 短袜
T-shirt|n. T恤衫
shorts|n. (pl.) 短裤
sweater|n. 毛衣
trousers|n.（pl.）裤子
shoe|n. 鞋
skirt|n. 裙子
dollar|n. 元（美国、加拿大等国的货币单位，符号位$）
big|adj. 大的；大号的
small|adj. 小的；小号的
short|adj. 短的；矮的
long|adj. 长的
woman|n. （pl. wemen）女子
can I help you|我能帮您吗
need|v. 需要
look|v. 看；看上去
pair|n. 一双；一对
take|v. 买下；拿；取
here you are|给你
ten|num. 十
eleven|num. 十一
twelve|num. 十二
thirteen|num. 十三
fifteen|num. 十五
eighteen|num. 十八
twenty|num. 二十
thirty|num. 三十
Mr.|（用于男子的姓氏或姓名前）先生
clothes|n. (pl.) 衣服；服装
store|n. 商店
buy|v. 购买；买
sale|n. 特价销售；出售
sell|v. 出售；销售；卖
all|adj. 所有的；全部的
price|n. 价格
boy|n. 男孩
a pair of|一双
very|adv. 很；非常
when|adv. （疑问副词）什么时候
month|n. 月；月份
January|n. 一月
February|n. 二月
march|n. （首字母大写时）三月
April|n. 四月
may|n. 五月
June|n. 六月
July|n. 七月
August|n. 八月
September|n. 九月
October|n. 十月
November|n. 十一月
December|n. 十二月
happy|adj. 愉快的；高兴的
happy birthday|生日快乐
old|adj. 年老的；旧的
how old|……多大年纪？……几岁了？
party|n. 聚会
see you|再见
first|num. 第一
second|num. 第二
third|num. 第三
fifth|num. 第五
eighth|num. 第八
ninth|num. 第九
twelfth|num. 第十二
twentieth|num. 第二十
test|n. 检验；检查
trip|n. 旅游；旅行
art|n. 艺术；美术
festival|n. （音乐、戏剧等的）会演节；节日
dear|adj. 亲爱的
student|n. 学生
thing|n. 东西；事情
term|n.学期
busy|adj. 忙碌的；无暇的
time|n. 时间
have a good time|（表示祝愿） 过得愉快
there|adv.（在）那里
favorite|adj. & n. 特别喜爱的（人或事物）
subject|n. 学科；科目
science|n. 科学
PE|n. 体育
music|n. 音乐；乐曲
math|n. 数学
Chinese|n. 语文；汉语 adj. 汉语的；中国的
geography|n. 地理（学）
history|n. 历史
why|adv. 为什么
because|conj. 因为
Monday|n. 星期一
Friday|n. 星期五
Saturday|n. 星期六
free|adj. 空闲的
cool|adj. 妙极的；酷的
Tuesday|n. 星期二
Wednesday|n. 星期三
Thursday|n. 星期四
Sunday|n. 星期日
a.m.|(= a.m.) 上午
p.m.|(= p.m.) 下午；午后
useful|adj. 有用的；有益的
from|prep. （表示开始的时间）从……开始
Mrs.|n. （用于女子姓氏或姓名前）太太；夫人
finish|v. 完成；做好
lesson|n. 课；一节课
hour|n. 小时
for sure|无疑；肯定

