gate|n. 大门
by|prep. (表示方式,如乘车等);按照 adv. 经过
subway|(=underground BrE) n. 地铁
always|adv. 总是,一直
come on|快点儿;加油;来吧
on foot|步行
plane|n. 飞机
train|n. 火车 v. 培训
ship|n. (大)船,舰
boat|n. 小船,舟
weekday|n. 工作日
early|adj. 早的;提早的 adv. 早地;提早
bird|n. 鸟
catch|v. 捉住;接住;染疾
worm|n. 软体虫
sometimes|adv. 有时
seldom|adv. 很少
walk|v. & n. 步行;散步
never|adv. 从不
ride|v. 骑(自行车,马等)
park|n. 公园 v. 停(车)
watch|v. 观看;当心 n. 手表
TV|(=television) n. 电视
watch TV|看电视
soccer|(=football BrE) n. 足球(运动)
movie|(=film BrE) n. 电影
begin|v. 开始
at school|在学校;在上课
after|prep. 在...后 conj. 在...以后
bed|n. 床
basketball|n. 篮球
swim|v. & n. 游泳
listen|v. (注意地) 听
music|n. 音乐
library|n. 图书馆
week|n. 星期, 周
once|adv. 一次;曾经 conj. 一旦
twice|adv. 两次;两倍
great|adj. 伟大的;好极的
wall|n. 墙
the Great Wall|长城
life|n. 生活;生命
American|adj. 美国的 n. 美国人
or|conj. 或者;否则
over|adv. 结束;穿过;多于 prep. 在…上面
more|det. 更多的 adv. 更多
talk|v. & n. 谈话
make|v. 做,制造; 使成为
card|n. 卡片,贺卡
boring|adj. 没趣的,无聊的
soon|adv. 很快,马上
classroom|n. 教室
playground|n. 操场
lab|(=laboratory) n. 实验室
computer|n. 计算机
room|n. 房间;空间
hall|n. 大厅,礼堂
dining hall|餐厅
gym|(=gymnasium) n. 体育馆,健身房
building|n. 建筑物,楼房
swimming|n. 游泳
pool|n. 水池,水塘
clean|v. 使…干净 adj. 干净的
do some cleaning|打扫
run|v. 跑
dance|v. & n. 跳舞
borrow|v. 借,借用
workbook|n. 练习册
course|n. 过程,课程
of course|当然
use|v. 用,使用 n. 用,使用
look for|寻找
shelf|n. 架子
keep|v. 保存;保持
must|modal v. 必须
return|v. 归还;回来
on time|准时,按时
newspaper|n. 报纸
lost and found|失物招领处
money|n. 钱
wallet|n. 钱包
around|adv. & prep. 到处,围绕
few|adj. 很少,不多 pron. 很少人(或事物,地方)
a few|一些
game|n. 比赛;运动;游戏
sit|v. 坐
ping-pong|n. 乒乓球运动
lesson|n. 课
write|v. 写
aha|interj. 啊哈
blackboard|n. 黑板
at the back of|在 ... 的后面
draw|v. 绘画;抽签 n. 抽签,抽奖
picture|n. 图片
because|conj. 因为
Japanese|adj. 日本的;日本人的;日语的 n. 日语;日本人
wonderful|adj. 精彩的
also|adv. 也,而且
Wednesday|n. 星期三
Monday|n. 星期一
Tuesday|n. 星期二
Thursday|n. 星期四
Friday|n. 星期五
physics|n. 物理(学)
geography|n. 地理(学)
art|n. 美术,艺术
history|n. 历史
math|(=mathematics) n. 数学
biology|n. 生物(学)
politics|n. 政治
science|n. 科学
meeting|n. 会议;会面
easy|adj. 容易的
interesting|adj. 有趣的
difficult|adj. 难的
learn|v. 学习,学会
which|det. & pron. 哪一个,哪一些
subject|n. 学科;主题
best|adj. 最好地(的)(good和well的最高级)
study|v. 学习;研究 n. 书房
outdoor|adj. 户外的
activity|n. 活动
attention|n. 注意
between|prep. 在...中间
stamp|n. 邮票 v. 跺(脚)
Saturday|n. 星期六
night|n. 夜晚
sound|n. 声音 v. 听起来好像
February|n. (Feb.)二月
hard|adj. 努力的;困难的 adv. 艰难地;努力地
late|adv. 晚,迟 adj. 迟(的),晚(的)
PE|(=physical education) n.体育
beautiful|adj.美丽的
garden|n. 花园
bedroom|n.卧室
second|num. & adv. 第二
floor|n. 楼层;地板
and so on|等等
upstairs|adv. 在(或向)楼上
kitchen|n. 厨房
dining room|餐厅
living room|客厅,起居室
bathroom|n. 浴室;洗手间
first|num. & adv. 第一
lamp|n. 灯
clock|n. 钟
near|prep. 在…附近 adv. 在附近 adj. 近的
under|prep. 在...下面;少于
chair|n. 椅子
behind|prep. 在...后面
front|n. 前面;前部 adj. 前面的;前部的
in front of|在...前面
guitar|n. 吉他
window|n. 窗户
table|n. 桌子;表格
key|n. 钥匙;关键
put|v. 放
away|adv. 离开
put away|将…收起
door|n. 门
look after|照顾
thing|n. 东西;事情
center|n. 中心
in the center of|在…中心
yard|n. 院子
flower|n. 花
house|n. 房子
large|adj. 大的,巨大的
left|n. 左,左边 adv. 向左 adj. 左边的
model|n. 模型;模特儿
only|adv. 仅仅,只有 adj. 仅有的,唯一的
townhouse|n. 排房
farmhouse|n. 农场住宅
country|n. 农村;国家
apartment|n. (美)公寓套房
rent|v. 租借;出租
quiet|adj. 安静的
month|n. 月,月份
for rent|出租
neighbor|n. 邻居
store|n. (大型)百货商店
bank|n. 银行;岸
street|n. 街道
corner|n. 拐角;角
post|n. 邮件;邮政 v. 邮寄
post office|邮局
bookstore|n. (美)书店
parking lot|停车场
supermarket|n. 超市
railway|n. 铁路
station|n. 车站
end|n. 尽头;结尾 v. 结束
road|n. 路,道路,公路
such as|例如
community|n. 社区
child|(pl.children) n. 儿童,小孩
a lot of|(=lots of)许多,大量
sport|n. 体育运动
close|adj. 接近;亲密的 v. 关,关闭
close to|靠近
far|adj. 远的 adv. 远
far from|远离
service|n. 服务
area|n. 地区; 面积
colorful|adj. 五彩缤纷的
sleep|v. & n. 睡觉
move|v. 搬(家);移动
countryside|n. 乡村,农村
city|n. 城市
noisy|adj. 吵闹的
traffic|n. 交通
cost|n. 费用,花费 v. 需付费
miss|v. 思念;错过
air|n. 空气;空中
fresh|adj. 新鲜的
along|prep. 沿着,顺着 adv. (与某人)一道,一起
turn|v. 转弯;(使)变成 n. 转弯;轮流
crossing|n. 十字路口
meter|n. 米
across|prep. 横过;在…对面
bridge|n. 桥
across from|在对面
until|conj. & prep. 直到...为止
kilometer|n. 千米,公里
should|modal v. 应该
change|v. 更换;改变 n. 找给的零钱
stop|n. 车站 v. 停止,阻止
sidewalk|n. (美)人行道
public|adj. 公共的,公众的 n. 公众,公开
light|n. 灯;灯光 adj. 明亮的;浅色的;轻的
crosswalk|n. 人行横道
danger|n. 危险
safe|adj. 安全的
hurt|adj. (身体上)受伤的 v. 受伤;感到疼痛
lose|v. 失去;丢失;输掉
accident|n. 事故
obey|v. 服从
rule|n. 规则
cross|v. 穿过
sign|n. 指示牌;符号
before|conj. 在…以前 prep. 在…以前;在…前面 adv. 以前
both|pron. 两个，两个都
third|num. 第三
last|adv. 最后;最近 det. 最近的;最后的 v. 持续
careful|adj. 小心的
ticket|n. 罚款单;票
speed|v. 超速行驶 n. 速度
wrong|adj. 错误的;有问题的
place|n. 地点,地方
fast|adv. 快,迅速 adj. 快的,迅速的
down|prep. 沿着;向下 adv. 向下
hill|n. 小山,山丘
rest|n. 休息;其余
story|n. 故事,小说
writer|n. 作家,作者
novel|n. (长篇)小说
was|v. (am,is 的过去式)是
born|v. 出生
July|n. (Jul.)七月
fan|n. 迷;风扇
march|n.(首字母大写时) (Mar.)三月
April|n. (Apr.)四月
may|n. (首字母大写时)五月
June|n. (Jun.)六月
August|n. (Aug.)八月
September|n. (Sept.)九月
October|n. (Oct.)十月
November|n. (Nov.)十一月
December|n. (Dec.)十二月
January|n. (Jan.)一月
were|v. (are的过去式) 是
thousand|num. 千
birthday|n. 生日
date|n. 日期;约会
calendar|n. 日历
plan|v.& n. 计划,打算
celebrate|v. 庆祝
party|n.聚会,宴会;党派
fourth|num. 第四
fifth|num. 第五
sixth|num. 第六
seventh|num. 第七
eighth|num. 第八
ninth|num. 第九
tenth|num. 第十
twelfth|num. 第十二
twentieth|num. 第二十
present|n. 礼物
shape|n. 形状 v. 使成为...形状
ball|n. 球;舞会
afraid|adj. 担心；害怕
star|n. 星;明星
mouse|(pl.mice)n. 老鼠
square|n. 正方形;广场;平方 adj. 正方形的
circle|n. 圆,圆圈 v. 圈出
triangle|n. 三角形
rectangle|n. 长方形
oval|n. 椭圆 adj. 椭圆形的
centimeter|n. (cm)厘米
cake|n. 蛋糕
Mrs.|n. 太太,夫人
piano|n. 钢琴
else|adv. 别的, 其他的
disco|n. 迪斯科
perform|v. 表演
ballet|n. 芭蕾舞
have a good time|玩得高兴
smart|adj. 聪明的
count|v. (按顺序)数数
ago|adv. 以前
London|n. 伦敦
at the age of|在...岁时
word|n. 单词
magic|adj. 有魔力的
trick|n. 把戏;诡计
enjoy|v. 享受;欣赏
himself|pron. 他自己
enjoy oneself|过得愉快
kung fu|n. 功夫
yesterday|adv. 在昨天 n. 昨天
ouch|interj. 哎哟
matter|n. 问题
fall|v. 跌倒;落下 n. 秋季(=autumn BrE)
poor|adj. 可怜的;贫穷的
myself|pron. 我自己
wash|v. 洗
at once|立刻, 马上
washroom|n. 洗手间
forget|v. 忘记
bring|v. 带来
candle|n. 蜡烛
wish|n. 愿望,希望 v, 希望
blow|v. 吹;刮风
blow out|吹灭
everyone|pron. 每人, 人人
sunny|adj. 阳光充足的
delicious|adj. 美味的,可口的,
musical|adj. 音乐的
everything|pron. 一切;每件事
minute|n. 分钟
start|v. 开始;出发 n. 开头
not any more|再也(不),(不)再
weather|n. 天气
spring|n. 春天
warm|adj. 温暖的,热心的
season|n. 季节
summer|n. 夏天
hot|adj. 热的;辣的
climb|v. 爬,攀登
winter|n. 冬天
cold|adj. 冷的 n. 寒冷;感冒
rain|v. 下雨 n. 雨
snow|v. 下雪 n. 雪
rainy|adj. 阴雨的,多雨的
remember|v. 记得;记起
put on|穿,戴
raincoat|n. 雨衣
outside|adv. 在外面,向外面
snowy|adj. 下雪多的
windy|adj. 多风的,风大的
foggy|adj. 有雾的
cloudy|adj. 多云的,阴天的
bright|adj. 明亮的
temperature|n. 温度
low|adj. & adv. 低;矮
holiday|n. 假期
umbrella|n. 伞
sunglasses|n. 太阳镜
shorts|n. 短裤
travel|v. & n. 旅行,旅游
wear|v. 穿,戴
suddenly|adv. 突然
shine|v. 发光,照耀
better|adv. 更好
had better|应该,最好
Australia|n. 澳大利亚
most|det. & pron. 大多数 adv. 最
sun|n. 太阳,阳光
later on|后来
come back to life|复苏;复活
come out|开花;出版,发行
heavily|adv. 猛烈地
harvest|n. & v. 收割,收获
busy|adj. 忙于(做某事),忙碌的
leaf|n. 叶子
wind|n. 风
strongly|adv. 强烈地
ice|n. 冰
hat|n. (常指带檐的)帽子
Beijing Opera|京剧
right away|立即, 马上
ourselves|pron. 我们自己
hope|v. & n.希望,期望
trip|n. 旅行,旅游
noon|n. 正午,中午
together|adv. 一起,共同
interest|n. 兴趣, 趣味
Germany|n. 德国
India|n. 印度
hometown|n. 家乡,故乡
anytime|adv. 在任何时候
all year round|一年到头
camera|n. 照相机
tent|n. 帐篷
prepare|v. 准备
prepare for|为...作准备
share|v. 分享,共用
fun|n. 乐趣
clothing|n. 衣服
carry|v. 携带;拿,提
decide|v. 决定
dangerous|adj. 有危险的
stay|v. & n. 待,停留
alone|adv. 独自;单独
keep away from|远离
mountain|n. 高山
arrive|v. 到达
friendly|adj. 友好的
gift|n. 礼物
festival|n. 节日
Spring Festival|春节
dumpling|n. 饺子
dragon|n. 龙
Christmas|n. 圣诞节
turkey|n. 火鸡(肉)
lantern|n. 灯笼
Lantern Festival|元宵节
lunar|adj. 月亮的,月球的
sweet|adj. 甜的
luck|n. 好运,幸运
riddle|n. 谜语
thanksgiving|n. 感恩节
pumpkin|n. 南瓜
pie|n. 果馅饼
Easter|n. 复活节
believe|v. 相信
Christ|n. 耶稣基督
Mid-Autumn Festival|中秋节
mooncake|n. 月饼
full|adj. 满的,充满的
moon|n. 月亮
important|adj. 重要的
decorate|v. 装饰
eve|n. (尤指宗教节假日的)前夜
church|n. 教堂
put up|挂起
stocking|n. 长筒袜
fireplace|n. 壁炉
open|v. 打开 adj. 开放的;敞开的
Santa Claus|n. 圣诞老人
special|adj. 特别的,专门的
greet|v. 和(某人)打招呼(或问好)
merry|adj. 愉快的
grape|n. 葡萄
Jewish|adj. 犹太人的
honey|n. 蜂蜜
event|n. 重要事情,大事
stay up|熬夜
midnight|n. 午夜
lucky|adj. 运气好的,幸运的
lucky money|n. 压岁钱
Halloween|n. 万圣节前夕
scary|adj. 吓人的
ghost|n. 鬼,幽灵
knock|v. & n. 敲
knock on|敲
shout|v. & n. 呼喊
treat|n. & v. 款待,招待
labor|n. 劳动
International Labor Day|国际劳动节
Dragon Boat Festival|龙舟节(端午节)
race|n. 竞赛,赛跑
national|adj. 国家的
National Day|国庆节
flag|n. 旗
places of interest|名胜
PRC|中华人民共和国




